Numer rachunku: 09187010781024522584470003,
Właściciel: GRAŻYNA ĆWIKŁA WIĘCEK,
Historia operacji za okres od 01.07.2022 do 20.08.2022,
Liczba operacji: 8,
Suma uznań: 2030.36 PLN,
Suma obciążeń: -5.77 PLN,
Data księgowania,Data operacji,Rodzaj operacji,Kwota,Waluta,Dane kontrahenta,Numer rachunku kontrahenta,Tytuł operacji,Saldo po operacji,
18-08-2022,18-08-2022,Przelewy przychodzące,200,PLN,"GRAŻYNA ĆWIKŁA WIĘCEK|UL.PRZYJAŹNI 34 M.2|00-997 WARSZAWA",09114020040000320232381451,"OSZCZĘDNOŚCI",6566.22,
11-08-2022,11-08-2022,Przelewy przychodzące,500,PLN,"GRAŻYNA KRZYSZTOF ĆWIKŁA WIĘCEK UL. PRZYJAŹNI|34/2 00-997 WARSZAWA",60191010482517623529030001,"oszczędności",6366.22,
10-08-2022,10-08-2022,Przelewy przychodzące,300,PLN,"GRAŻYNA ĆWIKŁA WIĘCEK|PRZYJAŹNI 34/2|00-997 WARSZAWA",06103000190109851805145770,"OSZCZĘDNOŚCI",5866.22,
31-07-2022,31-07-2022,Inne,-5.77,PLN,,,"Podatek - Naliczanie odsetek",5566.22,
31-07-2022,31-07-2022,Odsetki,30.36,PLN,,,"Naliczanie odsetek",5571.99,
18-07-2022,18-07-2022,Przelewy przychodzące,200,PLN,"GRAŻYNA ĆWIKŁA WIĘCEK|UL.PRZYJAŹNI 34 M.2|00-997 WARSZAWA",09114020040000320232381451,"OSZCZĘDNOŚCI",5541.63,
11-07-2022,11-07-2022,Przelewy przychodzące,500,PLN,"GRAŻYNA KRZYSZTOF ĆWIKŁA WIĘCEK UL. PRZYJAŹNI|34/2 00-997 WARSZAWA",60191010482517623529030001,"oszczędności",5341.63,
11-07-2022,11-07-2022,Przelewy przychodzące,300,PLN,"GRAŻYNA ĆWIKŁA WIĘCEK|PRZYJAŹNI 34/2|00-997 WARSZAWA",06103000190109851805145770,"OSZCZĘDNOŚCI",4841.63,
